 ________  ______    ______   ________   __   __     
/_______/\/_____/\  /_____/\ /_______/\ /_/\ /_/\    
\__.::._\/\:::_ \ \ \:::__\/ \::: _  \ \\:\ \\ \ \   
   \::\ \  \:(_) ) )_\:\ \  __\::(_)  \ \\:\ \\ \ \  
   _\::\ \__\: __ `\ \\:\ \/_/\\:: __  \ \\:\_/.:\ \ 
  /__\::\__/\\ \ `\ \ \\:\_\ \ \\:.\ \  \ \\ ..::/ / 
  \________\/ \_\/ \_\/ \_____\/ \__\/\__\/ \___/_(
	